.......................
...***.................
...*p**************....
...*.1111....74444*....
...*.********7**!**....
...*.*....44*7*4.4*....
...*.*11.744*7*4.4*....
...*.*111744*.*111*....
...*.*111744*.*111*....
...*.****7***.*111***..
...*......4444*11144*..
...**********.*.P.***..
............*.**.**....
............*....*.....
............******.....