...................
........p..........
...................
......1111.........
...................
...................
......4444.........
...................
...................
......77777........
...................
...................
.........P.........
...................
......*......*.....
...................
...................
